12
10
WWWWWWWWWWWW
WFFFFFFFFFFW
WFFFFFFFFFFW
WFFFPFFFFFFW
WFFFFFFFFFFW
WFFFFFFFFFFW
WFFFBFFFFFFW
WFFFFFFFFFFW
WFFFFFFFFFFW
WWWWWWWWWWWW
