12
10
WWWWWWWWWWWW
WFFFFFWFFFFW
WFBFFFWFFFFW
WFFFPFWWWFFW
WFFFFFFFFFFW
WFFFFFWFFFFW
WFWFBFFFFFFW
WFFFFFFFWFFW
WFFFFWFFFFFW
WWWWWWWWWWWW
